%%%%%
%. P%
% . %
%%%%%
% G%%
%%%%%
